CASTANEA DENTATA (RELATED: AMERICAN CHESTNUT)	Castanea dentata
MEDICAGO SATIVA (RELATED: LUCERNE)	Medicago sativa
MALUS DOMESTICA (RELATED: APPLE)	Malus domestica
PRUNUS DULCIS (RELATED: ALMOND)	Prunus dulcis
PRUNUS ARMENIACA (RELATED: APRICOT)	Prunus armeniaca
PERSEA AMERICANA (RELATED: AVOCADO)	Persea americana
HORDEUM VULGARE SUBSP. VULGARE (RELATED: DOMESTICATED BARLEY)	Hordeum vulgare subsp. vulgare
HORDEUM VULGARE (RELATED: BARLEY)	Hordeum vulgare
PHASEOLUS VULGARIS (RELATED: STRING BEAN)	Phaseolus vulgaris
LACTUCA SATIVA (RELATED: GARDEN LETTUCE)	Lactuca sativa
BRASSICA OLERACEA VAR. CAPITATA (RELATED: CABBAGE)	Brassica oleracea var. capitata
CITRUS X MICROCARPA (RELATED: CALAMONDIN)	Citrus x microcarpa
BRASSICA NAPUS (RELATED: RAPE)	Brassica napus
DIANTHUS CARYOPHYLLUS (RELATED: CLOVE PINK)	Dianthus caryophyllus
DAUCUS CAROTA (RELATED: CARROT)	Daucus carota
MANIHOT ESCULENTA (RELATED: CASSAVA)	Manihot esculenta
APIUM GRAVEOLENS DULCE GROUP (RELATED: STALK CELERY)	Apium graveolens var. dulce
PRUNUS AVIUM (RELATED: SWEET CHERRY)	Prunus avium
CICER ARIETINUM (RELATED: CHICKPEA)	Cicer arietinum
CAPSICUM FRUTESCENS (RELATED: HOT PEPPER)	Capsicum frutescens
RAPHANUS SATIVUS VAR. NIGER (RELATED: CHINESE RADISH)	Raphanus sativus var. niger
GOSSYPIUM HIRSUTUM (RELATED: UPLAND COTTON)	Gossypium hirsutum
CUCURBITA MOSCHATA (RELATED: CROOKNECK PUMPKIN)	Cucurbita moschata
CUCUMIS SATIVUS (RELATED: CUCUMBER)	Cucumis sativus
SOLANUM MELONGENA (RELATED: EGGPLANT)	Solanum melongena
LINUM USITATISSIMUM (RELATED: FLAX)	Linum usitatissimum
CUCUMIS ANGURIA (RELATED: GHERKIN)	Cucumis anguria
VITIS VINIFERA (RELATED: WINE GRAPE)	Vitis vinifera
CITRUS X PARADISI (RELATED: GRAPEFRUIT)	Citrus X paradisi
CAPSICUM ANNUUM (NO COMMON NAME FOUND)	Capsicum annuum
LOLIUM MULTIFLORUM (RELATED: ITALIAN RYEGRASS)	Lolium multiflorum
CITRUS LIMON (RELATED: LEMON)	Citrus limon
LILIUM (RELATED: LILY)	Lilium sp.
CITRUS AURANTIIFOLIA (RELATED: LIME)	Citrus aurantiifolia
ZEA MAYS (RELATED: MAIZE)	Zea mays
ZEA MAYS SUBSP. MAYS (RELATED: MAIZE)	Zea mays subsp. mays
ZEA MAYS SUBSP. MEXICANA (RELATED: TEOSINTE)	Zea mays subsp. mexicana
CUCUMIS MELO (RELATED: MUSKMELON)	Cucumis melo
PRUNUS PERSICA VAR. NUCIPERSICA (RELATED: NECTARINE)	Prunus persica var. nucipersica
AVENA SATIVA (RELATED: OAT)	Avena sativa
OLEA EUROPAEA (RELATED: COMMON OLIVE)	Olea europaea
ALLIUM CEPA (RELATED: ONION)	Allium cepa
PETROSELINUM CRISPUM (RELATED: PARSLEY)	Petroselinum crispum
PETROSELINUM CRISPUM (RELATED: PARSLEY) (NON-HOST BIOASSAY)	Petroselinum crispum
PRUNUS PERSICA (RELATED: PEACH)	Prunus persica
PISUM SATIVUM (RELATED: PEA)	Pisum sativum
ARACHIS HYPOGAEA (RELATED: PEANUT)	Arachis hypogaea
PYRUS COMMUNIS (RELATED: PEAR)	Pyrus communis
SOLANUM TUBEROSUM (RELATED: POTATO)	Solanum tuberosum
RAPHANUS SATIVUS (RELATED: RADISH)	Raphanus sativus
ORYZA SATIVA (RELATED: RICE)	Oryza sativa
ROSA (NO COMMON NAME FOUND)	Rosa sp.
CITRUS JAMBHIRI (RELATED: ROUGH LEMON)	Citrus jambhiri
SECALE CEREALE (RELATED: RYE)	Secale cereale
LOLIUM PERENNE (RELATED: PERENNIAL RYEGRASS)	Lolium perenne
SORGHUM BICOLOR (RELATED: SORGHUM)	Sorghum bicolor
GLYCINE MAX (RELATED: SOYBEAN)	Glycine max
FRAGARIA X ANANASSA (RELATED: STRAWBERRY)	Fragaria x ananassa
ARABIDOPSIS THALIANA (RELATED: THALE CRESS) (NON-HOST BIOASSAY)	Arabidopsis thaliana
ARABIDOPSIS THALIANA (RELATED: THALE CRESS)	Arabidopsis thaliana
NICOTIANA TABACUM (RELATED: COMMON TOBACCO)	Nicotiana tabacum
NICOTIANA TABACUM (RELATED: COMMON TOBACCO) (NON-HOST BIOASSAY)	Nicotiana tabacum
SOLANUM LYCOPERSICUM (RELATED: TOMATO)	Solanum lycopersicum
CITRUS SINENSIS (RELATED: SWEET ORANGE)	Citrus sinensis
CITRULLUS LANATUS SUBSP. VULGARIS (RELATED: WATERMELON)	Citrullus lanatus subsp. vulgaris
ERAGROSTIS CURVULA (RELATED: WEEPING LOVE GRASS)	Eragrostis curvula
TRITICUM (RELATED: WHEAT)	Triticum sp.
CUCURBITA MAXIMA (RELATED: WINTER SQUASH)	Cucurbita maxima
GERBERA (NO COMMON NAME FOUND)	Gerbera sp.
STYLOSANTHES (NO COMMON NAME FOUND)	Stylosanthes sp.
VITIS (NO COMMON NAME FOUND)	Vitis sp.
TRITICUM AESTIVUM (RELATED: BREAD WHEAT)	Triticum aestivum
NICOTIANA BENTHAMIANA (NO COMMON NAME FOUND) (NON-HOST BIOASSAY)	Nicotiana benthamiana
CYNARA CARDUNCULUS VAR. SCOLYMUS (RELATED: GLOBE ARTICHOKE)	Cynara cardunculus var. scolymus
STYLOSANTHES GUIANENSIS (RELATED: STYLO)	Stylosanthes guianensis
BRASSICA JUNCEA (RELATED: BROWN MUSTARD)	Brassica juncea
BRASSICA OLERACEA (NO COMMON NAME FOUND)	Brassica oleracea
BRASSICA CARINATA (RELATED: ETHIOPIAN MUSTARD)	Brassica carinata
SOLANUM HUANCABAMBENSE (NO COMMON NAME FOUND)	Solanum huancabambense
SOLANUM MICRODONTUM (NO COMMON NAME FOUND)	Solanum microdontum
NICOTIANA BENTHAMIANA (NO COMMON NAME FOUND)	Nicotiana benthamiana
VICIA FABA (RELATED: FAVA BEAN)	Vicia faba
SOLANUM PERUVIANUM (RELATED: PERUVIAN TOMATO)	Solanum peruvianum
TRITICUM AESTIVUM X TRITICUM TIMOPHEEVI (RELATED: COMMON WHEAT X SANDURI WHEAT)	Triticum aestivum x Triticum timopheevi
CITRUS X TANGELO (RELATED: TANGELO)	Citrus × tangelo
CASTANEA MOLLISSIMA (RELATED: CHINESE CHESTNUT)	Castanea mollissima
PINUS CONTORTA (RELATED: LODGEPOLE PINE)	Pinus contorta
CITRUS IYO (NO COMMON NAME FOUND)	Citrus x iyo
CITRUS UNSHIU (RELATED: SATSUMA MANDARIN)	Citrus unshiu
AESCHYNOMENE VIRGINICA (NO COMMON NAME FOUND)	Aeschynomene virginica
MALUS PRUNIFOLIA (NO COMMON NAME)	Malus prunifolia
PINUS THUNBERGII (RELATED: JAPANESE BLACK PINE)	Pinus thunbergii
THEOBROMA CACAO (RELATED: COCAO)	Theobroma cacao
POPULUS ALBA (RELATED: WHITE POPLAR)	Populus alba
HELIANTHUS ANNUUS (RELATED: COMMON SUNFLOWER)	Helianthus annuus
ERIOBOTRYA JAPONICA (RELATED: LOQUAT)	Eriobotrya japonica
HYLOCEREUS TRIGONUS (RELATED: STRAWBERRY-PEAR)	Hylocereus trigonus
CITRUS LIMONIA (RELATED: MANDARIN LIME)	Citrus × limonia
CHENOPODIUM QUINOA (RELATED: QUINOA)	Chenopodium quinoa
CITRUS RETICULATA (RELATED: TANGERINE)	Citrus reticulata
PELARGONIUM X HORTORUM (RELATED: ZONAL PELARGONIUM)	Pelargonium x hortorum
PRUNUS AMERICANA (RELATED: GOOSE PLUM)	Prunus americana
FESTUCA ARUNDINACEA (RELATED: TALL FESCUE)	Festuca arundinacea
BRASSICA RAPA SUBSP. PEKINENSIS (RELATED: CHINESE CABBAGE)	Brassica rapa subsp. pekinensis 
BRACHYPODIUM  DISTACHYON (RELATED: STIFF BROME)	Brachypodium distachyon
BRASSICA RAPA SUBSP. CHINENSIS (RELATED: BOK-CHOY)	Brassica rapa subsp. chinensis
SACCHARUM OFFICINARUM (RELATED: SUGARCANE)	Saccharum officinarum
BRASSICA OLERACEA VAR. BOTRYTIS (RELATED: CAULIFLOWER)	Brassica oleracea var. botrytis
BRASSICA OLERACEA VAR. ITALICA (RELATED: SPROUTING BROCCOLI)	Brassica oleracea var. italica
POPULUS X CANADENSIS (RELATED: CAROLINA POPLAR)	Populus x canadensis
MUSA X PARADISIACA (RELATED: BANANA)	Musa × paradisiaca
LEMNA MINOR (NO COMMON NAME FOUND)	Lemna minor
PYRUS PYRIFOLIA VAR. CULTA (RELATED: YAMA-NASHI)	Pyrus pyrifolia var. culta
PINUS MASSONIANA (RELATED: CHINESE RED PINE)	Pinus massoniana
MUSA ACUMINATA (RELATED: DWARF BANANA)	Musa acuminata
ROSA ODORATA (RELATED: TEA ROSE)	Rosa odorata
WHEAT	Triticum sp.
BRASSICA OLERACEA	Brassica oleracea
RICE	Oryza sativa
POTATO	Solanum tuberosum
BARLEY	Hordeum vulgare
THALE CRESS	Arabidopsis thaliana
SOYBEANS	Glycine max
GRAPE	Vitis sp.
MAIZE	Zea mays